000001990000199880000010200001889910000888888000000219988010002999999010010100010001000101001010199999999990F
000000000110001000000000020000001091000000088100000000000001011111010000002889900199008800000200121010101180F
X00000010000000002000000002100100009100000000000200001008880000002100001880002008800990088100000000000800000F
000000000001000000000000020000088000910000000000000188000000010088888000000100010000000200008800880000000000F
000004280108801400000000200300888800000004208800200000143420008888880433340303330888804040888800030040043430F