00080090000000000008888000000100000888800000010009999000000018888889999991000000F
00080090000888800000000000000000000999900000010000088800010000088888899990000000F
X0080090000000000000000888800001000000000000000000000000000000000888888990010000F
00080090000000000000000000000000020000002000000020000000000000088888899990000000F
00030040000000010008888009999000000010000888803000000400000000888888889990100000F