0000000000010000000000010088880100000000008888010000000288000100000000088880010000020100999910000000000299199800100000000088999000000000208880000F
0000000000000000000100000000000020001000002088880000999901000000000000000001002000000001008888100000002088888800000000002880010000020000008888000F
X000000100000000000888800001008800000000000100000088000000108881000001002000088881000000000088881000000028889900020000000010000020202000008888800F
0000000000000000010000001000008800000001000010000000010001000000300008888830088880101101030088880030000199888810003000011030000000000210008888000F
0000000000100000000000000000208880000020008888800002888888000000303099300030008800099990033000000030000000000000003008888830881003000000008880000F